uno	kö
no	asià
abeja	ja pm
rey	ré
musica	sëü
feliz	siñoì
hora	horà
avispa	amàbmπ
uno	kö
dos	teü
tres	nëī
quince	kià ñà
mayo	mayo
todo	lajeī
todos	lajäī
día	jπ
día de	jπ kie
bueno	tsei
bien	tsei
niños	simai
hoy	nè
mucho	liö
hace	jüoi
mes	sėi
gente	chie
padre	jmaī
piedra	mkäü
cocina	jé jyí
señora	adöm
coco	mseü
murio	ajäü
esposa	adöm kiâi
ropa	apm
blanco	tié
hombre	añii
muerto	ajäü
cueva	tò nòò
dueño	jeu
animal	ja
hoyo	tò
fueron	ngô
entro	a éi
padres	jmaì siè
padre	jmaì
madre	siè
monte	je naü
mucho	liö
poder	wapéi
tiene	kiäi
pajaro	jötâ
ave	jötâ
niño	apei ñii
un día	kö jm
señor	adö ñii
león	adya leö
camina	angêī
anda	angêī
camino	oò jeu
mal	laį
romper	jeü
luna	sēi
bebé	yëi pei
mañanita	tò ié pei
teprano	tò ié
acuerdo	jaù reè
escuchoi	anäu
elefante	alefante
se enojo	ijö rakô
necesita	nia
hacer caso	roì
anecdota	jau ityà
una vez	kötâ
correcto	korè
lo que hay	isià
llegara	tyië
demasiado	liö mai
respeta	makô
para asi	kä lajö
platico	atyài jau
converso	atyài jau
fallecio	ajäü
su señora	adöm kiâi
enfermó	rachièè
trabaja	jüoi tá
sembrador	ajnei
maestro	atėī
trabajo	tá
para asi	kä lajö
plátano	utoó
animales	ja
agujero	tò
asi era	lanè màleį
palabra	jau
que dijo	ia lē
pequeño	peì
anecdota	jau ityà
te respeten	makòi nëi
bajo el agua	joò jπ
pensamientos	waitsei
entonces dijo	jö ajua
dia de muertos	jm kie ajäü
donde hacia	imàjuö
cuando fueron	kö mà ngôi
lo que cuentan	jau ityà
donde trabajaba	imàjuö tá
niñitos pequeños	simai pei
vestian ropa blanca	atiô apm tié
cuando llego el dia	kö mà tyiè jm
15 de mayo el maestro es el sembrador de los conocimientos del saber y se desvela por preparar sus clases y se preocupa por los niños hoy 15 de mayo día del maestro todo méxico conmemora el día del maestro el trabajador incansable	kià ñà sôī mayo atėī ajnei lajeī waeitsei tsei ikö lajäī simaì asià pm ijuöi lajeī majyi kie jüoi liö waitsei tsei kie simai nè kiä kià ñà sėi mayo jm kie lajäī atėī làtâ gò jπ kie lajäī atėī a äi ajuö tá lajeī jπ
el maestro se prepara cada día para heredar mejores conocimientos para los niños de méxico el día 15 de mayo día del maestro sin compensación por ser su día sigue trabajando y al mismo tiempo es criticado por exigir un salario justo para una educación justa	atėī lajeī k pà matäī kä lajö kuói waeitsei kie ikö simai pei ikö lajäī asiâ gò jπ jm kiä kià nà sėi mayo jm kie lajäī atėī jm jö ikö isià iyei iku oo jeù jüoi tá lė chie jau laī kiì lío nëi kie imm ilì liäì kaleù liö kä lajö silèi ko rè ño lajeì tá
el hombre que no puso la ofrenda cuando se acercaba el día de los muertos un niño le dijo a su papá no vas a poner ofrenda de muertos ? porque va venir mi mamá en ese día	añii asaku oo i äī lateī maá loò jm kie ajäü jö ajua jä apéi asaî jmaī i o asià tyà niyiè lajeī ikie ajäu ? kie tà ià jyô sià jnià jm jö
yo no voy hacer nada tu madre siempre estuvo en la cocina que venga a ver la piedra del fuego que es ahí donde siempre estuvo en vida así que cuando llegó el día dos de noviembre día de muertos se llevó a su hijo al campo a trabajar con él estaba trabajando cuando de pronto vio rumbo al pueblo que venía mucha gente vestida de blanco	asià juô siè nëi lajeī jm pà si sâi jé jyí wajyöī nià jeì mkäü pá kie itìniè jé jyí imàjuö tá kö mà tyiè jm kiä teü sēī noviembre jm kië ajäü jö jyaī ajö ngôi jé wajuöi tá imà sijuö tá jö jö ajèi tàyei jö ajêi chie a äi atiô apm tié
eran los muertos que venían del pueblo todos iban cargando las ofrendas que sus familiares habían puesto en el altar algunos llevaban cocos plátanos camotes calabazas tortillas de yuca pan etc y hasta atrás venía su mujer con la piedra y el se asustó mucho	ajäü pà dà ajêi a äi atiô jeu ajêi ajaü atī kiê lajeī màà aniè nëi yiè kachiô kië tiö mseü utoó mjyèi mà umá a ei jyèi sijnài a ei ñi iteį takò màjö adöm kiâi a äi akië mkäü pà ijö i ajuôi
entonces ella le dijo mira aquí vengo con esta piedra porque esto fue lo único que conocí cuándo vine en el mundo después de esto el hombre cayó enfermo su mujer había dicho esto porque ella lo había escuchado cuando éste se negó a poner la ofrenda al poco tiempo este hombre murió porque había hablado con su difunta esposa	ljô ajuôi jé tiô lajâi tie là kië kö mkäü pà mkäü pà ijö ajuô tá ta là kuâ mkú kö mà aleį jö rachièè añii a π kiä ajuà jö pà ajä i lànè nëi sàmakò lajeī ityài jm kie ajäü kö leè jm pà juo ateī jö ajäü añii äi kié tà ià atyài jau jyâi ajaü
el hombre de la cueva dice que hay dueños de los animales tejones mazates tepescuincles tigres en fin están en las cuevas de los cerros los cerros son iguales que los potreros con animales que tienen dueños se dice que los cerros y los animales tienen dueños porque así lo contaban los viejos pero ahora esto ya no se deja ver dicen que son los duendes a too dueños de los cerros y de todos los animales que hay ahí	añii kiä tò nòò jau sià sià jeu lajäī nai ja aki asäi angä adya jëü pà ja leį tiöì tò mà o tò kä lajeī amà leī kö nài lià ilèį joò aaà kie ja añiô chie amà ñà lajäī ja tiö siâ jä jeùi a äi a ié kii lajeī jau là ityà adö tiö lajäī jeù ja tiö asiè mà majniaì kie tà läī jeù lajäī ja tiô jeu lajeī amà isià nëi mkulà ñà lajäī naī ja
el otro día fueron dos señores a cazar tepescuincles y entraron a una cueva y ahí encontraron una vasija de barro la cueva era profunda pero ya no se metieron más al fondo porque no llevaban lámpara y porque uno de ellos empezó a sentirse mal a esta cueva nadie había entrado ellos se metieron porque traían rifles pero apenas pudieron porque se sentían muy mal	kö jm lingô ô adö ñii tiô wasiâi angä ijö a éi kö tò ijö achiì joò tò jö kö atsai imako adö tiô itò jö liö maì ku oo asié mà ngö tà naì kie tà là sièmàkiäi ujyī ijâ chie kiäi ajäi laī tò jö ijä chie asià mà a eī jö a éi tò jö kie tà là makiäi atéi latô a éi tò jö lamà jö pà ajä i lài aleī isawäi
dicen que se enfermaron porque les tocó un mal aire y ese mal aire es el dueño de la cueva pero es un aire malo porque uno de los señores se puso tieso y tuvieron que ir a buscarlo y lo encontraron tirado en el camino uno habló hasta el tercer día dicen que se pusieron así porque no quería el dueño que entraran en esa cueva	aleī arachiī kie tà là atē tyí laį éi nëi kie a éi tò tyí läī ayeì tò jô jeü chie tiô aleį sawáī kie tà là yëi tò jö alaį éi iwa nëi kie eùi päi tyí ngô chie awá niè kiì kie tà là rawà éi jö achiâi o ò jeu jä chie äi a lei teī nëī jm ajäi lajö kie tà là samà niè jeu toò jä isà nia si éi tò itiö lajäī jeu ja
creencia así era desde mucho más antes cuentan nuestros antepasados que los animales que habitan en este mundo piensan de diferente manera que cuando aúllan los coyotes es seguro que va a llover o viene el viento todos los animales tienen dueño quién los cuida que se llama chaneco el rey de los animales del monte como el venado mazate tejón armadillo tepescuincle etc	lajeī i âi lanè màleį majô nè jau ia lē lajäī jmaì siè a äi amàkichiä lajäī ja asiä nëi mkúlà juö waitséi makëi lateì oo atsái näü leį rè pà jyà ujπ o jyà tyi lajäī ja siä jéùi a äi a ié kiì a äi asäì añii akiä mà ré kiä lajäī naì ja asiâ je naü lià akuà näu asäi akiì ajèi angä
también hay otro rey de los animales acuáticos que se llama taneko es el que manda a los animales que viven en el agua estos dos seres están tan pequeños que no se pueden ver a simple vista pero tienen muchos poderes	lanè siä jä ré jeùi lajäī ja atiô joò jπ a äi asäi chaneco a äi ajuô éi ikö lajäī ja atiö joò jπ chie peì là asiâ jêi làmajô o jeù mneì liö wapéi kiäi
después de tres días de haberse asustado el niño cayó enfermo con mucha calentura sus padres ya no podían hacer nada porque no había médico en ése tiempo tuvieron que buscar al curandero el curandero le dijo que el niño se había asustado mucho por eso no hay que permitir que los niños anden en lugares solitarios	kö mà ateī nëī jm jö ratyëi apei ñii äi jmai siè apei äi si nï ė siâi aleį kie tà là asiâ atėīm mà siâ jm jô jö ngôi wajêi jä chie a äi atäī él oó ijö ajuài apeì itö imà iäį pì rachiì tié là jeù nëi asié mà kuo jeu ingëī apei jö ñââ
canción de la luna que salga la luna no le hagas caso a este hombrecito salga la luna vámonos de una vez este hombre es un caminante que salga la luna en su totalidad salga la luna vámonos de una vez salga la luna a este hombre no salga la luna vámonos de una vez	sëü kie jä sēi wà i aī sēī nè arô nëi jeu yëi pei là jau sēī mà kiä kötâ añii ià a ngêī jeu juö pà là wà i aī sēī la tâ jau sēī mà kiä kötâ jau sēī ajô ikö añii là jau sēī mà kiä kötâ
la cultura usileña era diferente antes de lo de ahora los moradores de la región usileña quienes vivieron anteriormente se vestían de calzón de manta los hombres y las mujeres se vestían de huipil que ellas mismas tejían no había personas que usaran pantalón y antes de empezar la semana mayor	lajeī itâī kie asiâ jé jeu jëi jönè iseį pà màleī jm itiè tònè là lajäī chie amakichiä a äi asiä je jeu jëi liö mài īsei matäī kiì añii mà si éi apm ki itéi apm yèi lajäī amπ tiô mà si éi amajau yëi ijö imajuöi tiöi asiä chie masiä atiö apm ikie tiè là latèi raliè jm tà éé
su diversión era el baile del carnaval en donde bailaban los hombres vestidos de huipil cubierto con pañuelo rojo y sombrero en sus cabezas y hablaban en chinanteco porque no había personas bilingües en ese tiempo	jö mà ma lili jä kie asièlià ijö imachiè añii tiö i ëi amajaù iéi ukuà nëi ñà liè apä yëi matyi ñà éi aujyi matyi lia lajäi tiöi lēi jau jm asià jau ñi ma lēi jm jö
muchas de estas cosas ya no se hacen ahora y los jóvenes ya no quieren hablar su lengua y las señoritas ya no se visten de huipil es importante rescatar las costumbres y las tradiciones de nuestros antepasados porque solamente de esta manera el pueblo indígena se identifica y sobre todo la lengua no se debe perder porque es una herencia primordial de nuestros padres	jm itiè tò nè ià asié ià nè màleī asié ma i lēi jau jm kie asié si éi amajau tié ia nià mako lajetī inè kie tà là leī kö itseèi nia ilē jau jm kiâ nia juö lajeī itsèi ikö lajätī adö tiö kie kö juà inè a loó itsei ikö jnia
refranes 1 la persona que come demasiado se le descompone su estómago 2 respeta para que seas respetado 3 el que anda con cuidado nunca tropieza 4 todo lo material se llega a romper	jau itséi naì kiö lajäī chie ake u liö mai jä i laī êi teü makô lajäī chie kä lajö makòi nëi nëī lajäī angêī korè oò jeu asià jä i laį kï lajeī isià tyië jm jeü
30 de abril hoy es día 30 de abril día del niño los niños merecen el respeto y el cariño porque ellos serán los futuros ciudadanos de méxico	ku oi jàu kiékià sētį abreì jm nè kiä kiekià sēį abreì jm kie lajäì simaì pei lajäì simài pei nia màköi ijäī tsèi kie tà là éi läì ajeù akiä gò jπ
el niño necesita cuidado el niño necesita alimentación tiene el derecho a la educación el niño adquiere todo el derecho el niño indígena debe tener el mismo derecho que los demás el niño indígena se alimenta diferente de los demás niños por falta de recursos	lajäī apei nia jêi lajäī apei nia ngêi lajäī apei nia si éi jaù tēī lajäī apei sià itsei ki i lajäī sima pei a äi a lējaujm kö naì pà kêi lajäī simài pei à äi a lē jau jm asia ko nai ke ui jñai simài pei a äi ajlâ tiô kie tà là nëi kié sà sià akaù
los niños tienen que asistir a la escuela obligatoriamente para que puedan defender sus derechos cuando sean grandes y los padres debemos de ayudar a nuestros hijos	lajī simaī pei nia si éi jaù tēi inaì ikiì kä lajô lìngâi ijö ijâi jm kie iè yiè latèi rajuôi läjäī jmai sii nia mà öi jöseī kä lajö litât korèè majyi
adivinanzas 1 soy un cochinito de piedra tengo tres patas todos los días me tienen sobre la mesa molcajete 2 una piedra ancha con tres patas encima de ella la señora contenta hace las tortillas metate 3 me parezco mucho al gato pero no lo soy y vivo en la selva el tigre	itìì jaù kö lâī jä añi pei ileį mkäü kiâ nëī matàī lπajeį jπ ratseì matàī nëi amesà abm kie añjäu teü kö mkäu éu kiä nëī matàī nëi mà êi juö adö a ei liö mài siñòi asitoò nëi lià ijnià atéi pa jnia asià läī siâ jnià je naü adya
cuento del leon y del grillo una vez el león iba caminando tranquilamente en una selva de repente se escuchó el canto del indefenso grillo que decía rey rey rey de tal manera que el león se enojó mucho con el grillo y se acercó y le dijo yo soy el rey de la selva entonces el grillo respondió está bien y siguió cantando	jau kuô kie adya leö jñà a la kö jm màēi adya leö jeù liö maì siñoì mà kie kö là là anäu kö sëü lako sajñài sëü kie a la ijö irajuà ré ré ré ijö rakô adya leö ikö a la ljö ajuà nià pa äi läį re kiä lajeį mà ijö ajuà a la atseì pà
el león se puso más enojado de tal manera que quería acabar con el pobre grillo entonces el grillo le dijo está bien tú eres el rey pero hagamos un trato reúne a toda tu gente y yo reúno a los míos para una pelea que será mañana como a esta hora para ver quien gana y el ganador de esta pelea será el rey	ijö a oó adya leö kö itià kä lajö lijä i tseì a la ijö ajuà a la tséi pà jö iläī nëi ré tiè là nià tyiè kö jaù reè nia tyiä kolàī lajäī ja kiâ ñà köñaī lajäį ja kiä lià kä lajö sitái tò ié pei horà là wania jnia äi kaį jm a äi a akaįjm a äi pa läi ré
el león juntó todos los animales de la selva el elefante el tigre jirafa jabalí coyote pantera y otros en cambio el grillo juntó a los animales más pequeños como las hormigas abejas avispas y abejones cuando llegó la hora de la pelea el león llamó al grillo y este respondió rey rey rey escondido en la basura el león empezó el ataque con sus soldados	adya leö äi atyäį kölaį lajäį įa kiâ alefante adya ja ku oo maláu angä atsái naü ja pá ñà kachiö ja asäį lià i a la atyiâi kölaį lajäì ja pèi abmm ja pm amàbmπ kömà atyiè hora jö isitäį tiöi adya atéi a la i a a la ajuà ré ré ré ramà jé lajeį makìì i adya leö maliè naì jñà lajäī aliéé kiä
el grillo también lanzó el ataque pero grande fue la sorpresa del león y sus gentes cuando las abejas avispas y todos los animales del grillo le picaron por todos lados del cuerpo del león y su gente y los demás animales salieron huyendo y así fue como los animales más pequeños vencieron al rey de la selva	i a a la atèi lajäį ja kiâ jö amàliì nài lià lakö saràjñài pà adya aleö aléī kö là là lajäī nài ja pm amàbmπ akáī éi lejäī ja kiä adya apm pai kiè tiö lajäī ja peì tiö akáī jm ja pei nè arasäi ré ré kiä lajä īnaì ja asiâ mà
la moraleja de este cuento es que no te debes confiar en el tamaño de un ser sino en la astucia que este tiene	lajeį jaù iratyà kuento ià asià nia roì jeù äi kö täi lajäī chie lajeī itseì ijuö pì nia
